1111111111111111111
1111111111111111111
11CC11CC111CCCCCC11
11CC11CC1111111CC11
11CC11CC1E11111CC11
11CCCCCC0P0CCCCCC11
11CCCCCC1E1CC111111
111111CC111CC111111
111111CC111CCCCCC11
1111111111111111111
1111111111111111111
